WWWWWWWWWWWWWWWWWWWWWWWWWWWWWWWWWWWWWW
W-----------------------W------------W
W-----------------------W--------E---W
W-----------------------------WWWWWWWW
W------------------------------------W
WWWWWWWWWWWWW---------------------C--W
W-----------WWWW---------WWWWWWWW----W
W--------------W---------------WW----W
WWWWWWWW--------------------C--WW----W
W--------------WWWWWWWWWW------WW----W
W--C-------------------WW------WW----W
WWWWWWWWWWWWWWW--------WW----WWWW----W
W----------------------------W-------W
W--P-----------------------WWW----C--W
WWWWWWWWWWWWWWWWWWWWWWWWWWWWWWWWWWWWWW