WWWWWWWWWWWWWWWWWWWWWWWWWWWWWWWWWWWWWWWWWWWWWWWWW
W-----------------------W-----------------------W
W-----------------------W-----------------------W
W-------------C---------W-----------------------W
W---B-------------------W------------W-----G----W
W-----------------------W------------W----------W
W------------C----------------WWWWWWWW----------W
WWWWWW------------------------------------------W
W---------D------------------------------D------W
W------------------------------------WWWWWWWWWWWW
WWWWWWWWWWWWW--------------D------C--W
W-----------WWWW---------WWWWWWWW----W
W--------------W---------------WW----WWWWWWWWWWW
W----C-------------------------WW--------------W
W------------------------------WW----------D---W
WWWWWWWW------------D-------C--WW--------------W
W--------------WWWWWWWWWW------WW-------WWWWWWWW
W-----D----------------WW------WW-------W
W----------------------WW---------------W
W-----------------C----WW---------------W
W--C-------------------WW------WW-------W
WWWWWWWWWWWWWWW--------WW-----WWW-------WWWW
W----------------------------W-------------W
W--P---------C--------D-----WW----C--------W
W------------------------------------------W
WWWWWWWWWWWWWWWWWWWWWWWWWWWWWWWWWWWWWWWWWWWW